######## #########
#......###.......#
#..@...|.|...R...#
#......###.......#
######## ####|####
            #.#   
            #.#    
            #.#   
            #.#    
            #.#   
            #.#    
            #.#
#############|################################################
#............................................................#
#............................................................#
#....................S.......................................#
#............................................................#
#...............S.........S..................................#
#............................................................#
#............................................................#
#............................................................#
#............................................................#
#............................................................#
#............................................................#
#............................................................#
##############################################################