######## #########
#......###.......#
#......|.|.......#
#......###.......#
######## ####|####
            #.#   
            #.#    
            #.#   
            #.#    
            #.#   
            #.#    
            #.#
#############|################################################
#............................................................#
#............................................................#
#............................................................#
#............................................................#
#............................SSSSSSSS........................#
#............................SSSSSSSS........................#
#..@.........................SSSSSSSS........................#
#............................................................#
#............................................................#
#............................................................#
#............................................................#
#............................................................#
##############################################################