######## #########
#......###.......#
#.P....|.|.......#
#......###.......#
######## ####|####
            #.#   
            #.#    
            #.#   
            #.#    
            #.#   
            #.#    
            #.#
#############.################################################
#............................................................#
#............................................................#
#............................................................#
#............................................................#
#............................................................#
#............................................................#
#............................................................#
#............................................................#
#............................................................#
#............................................................#
#............................................................#
#............................................................#
##############################################################